0,0,0,0,0,0,0,0,0,0
1,1,1,0,0,0,1,1,1,0
1,0,1,1,0,1,1,3,0,0
1,1,0,0,3,1,1,1,1,0
3,1,1,1,1,1,0,4,1,5
0,1,1,6,0,1,1,0,0,0
1,1,0,0,1,0,0,2,1,0
0,1,1,1,1,1,1,1,1,0
0,0,0,0,0,0,0,0,0,0
