1,0,0,0,0
1,6,1,3,0
1,0,1,2,4
0,0,1,0,6
0,0,3,2,5
