0,0,0,0,0,5,0,0,0
0,1,3,0,4,1,4,1,3
2,1,1,0,0,1,1,1,1
1,1,0,1,3,1,1,1,0
1,1,0,1,0,0,0,1,0
1,1,4,0,0,1,1,1,1
0,1,0,6,1,1,0,1,6
0,1,1,1,0,4,0,4,0
0,0,0,0,0,0,0,0,0
