0,0,0,0,0,0,0,0,0,5
6,0,1,1,1,1,1,1,0,1
1,0,1,0,0,1,1,1,0,1
1,1,1,1,1,1,0,1,1,1
0,0,0,6,0,1,0,1,1,3
2,1,1,1,1,1,0,0,1,0
1,0,1,0,0,1,1,0,1,1
1,1,3,0,3,1,1,1,1,0
0,0,0,0,0,0,0,0,0,0
